access	access
activation	activation
algorithm	algorithm
alignment	alignment
annotation	annotations
application	application
approach	approach
architecture	architectures
automatic	automatic
bilateral	bilateral
bringing	bringing
business	business
case	case
categorization	categorization
challenge	challenges
choreography	choreography
claim	claim
cleanup	cleanup
clinical	clinical
collaborative	collaborative
combination	combination
complexity	complexity
composing	composing
computing	computing
conjunctive	conjunctive
control	control
controlled	controlled
cooperation	cooperation
database	database
data	data
datum	data
dead	dead
delta	deltas
dependency	dependency
description	description
description	descriptions
design	design
designing	designing
directory	directories
discovery	discovery
dl	dl
document	documents
dog	dog
editing	editing
editor	editor
engineering	engineering
entailment	entailments
environment	environments
evolution	evolution
expressive	expressive
extraction	extraction
finding	finding
finnish	finnish
food	food
foundation	foundations
fragment	fragment
framework	framework
fundamental	fundamentals
fundamentals	fundamentals
graph	graph
graph	graphs
guideline	guidelines
health	health
heterogeneous	heterogeneous
history	history
human	human
hybrid	hybrid
incoherence	incoherence
information	information
instance	instance
instantiation	instantiation
integrating	integrating
integration	integration
intelligence	intelligence
interactive	interactive
interface	interfaces
interoperability	interoperability
interpretation	interpretation
ir	ir
justification	justifications
kernel	kernel
knowledge	knowledge
language	language
layer	layer
legacy	legacy
lesson	lesson
leveraging	leveraging
lexical	lexical
life	life
lightweight	lightweight
logical	logical
logic	logics
making	making
management	management
mapping	mapping
mapping	mappings
marketplace	marketplaces
measuring	measuring
mechanism	mechanism
mechanism	mechanisms
metadata	metadata
method	method
method	methods
migration	migration
mining	mining
model	model
model	models
module	modules
multimedia	multimedia
natural	natural
negation	negation
negotiation	negotiation
network	network
nucleus	nucleus
ontology	ontologies
ontology	ontology
open	open
owl	owl
patient	patient
pattern	pattern
pattern	patterns
performance	performance
person	persons
perspective	perspective
poet	poets
potential	potential
power	power
practice	practice
probabilistic	probabilistic
problem	problem
processing	processing
profiling	profiling
project	projects
protocol	protocol
public	public
query	queries
query	query
reasoning	reasoning
recipe	recipes
record	records
relation	relation
relevance	relevance
remote	remote
repository	repository
retrieval	retrieval
role	role
scalable	scalable
schema	schemas
science	science
science	sciences
search	search
sector	sector
semantic	semantic
semantics	semantics
service	service
service	services
services	services
shim	shim
simple	simple
social	social
space	spaces
statistics	statistics
statistic	statistics
steps	steps
step	steps
store	stores
strategy	strategies
structured	structured
study	study
support	support
synchronization	synchronization
system	systems
tableau	tableau
task	tasks
technology	technologies
technology	technology
text	text
text	texts
tool	tool
training	training
translation	translation
trial	trials
triple	triple
uncertainty	uncertainty
using	using
virtual	virtual
warehouse	warehouse
weaving	weaving
web	web
workflow	workflows
